00000000000000000000
60000000000000000000
0000x0000000xxxx0000
000xx0000000000x0000
00xxx0000000000x000x
0000000xxxxx000x0000
000000000000000x0000
000000000000000xxx00
00000000000000000000
00x00000000xx0000000
00x00xx0000x00000000
00x00x00000x00000000
00000000000000000000
000000000000000x0000
000000x00000000x0000
000000x0000x000x0000
00xxxxx0000xxxxx0000
00000000000x00000000
00000000000000000000
00000000000000000008
